######## ################ #                                                
    ############# # ######                                                 
                                                                           
    ### ######### # #######################################################
    ### #### # # ## # # ################# #####                            
        ### ################# ########################## ######## ##### ###
        ## ###################### ## ####################                  
            ###### # ################################                      
            ###### # ################################                      
        #                                                                  
        ## ######## ## # ## ##################### ## ####################  
            ############## #####                                           
        #      @                                                            
        ## ######## # # ## ##################### ## ##################      
            ####### # ##                                                    
        #                                                                   
    #                                                                       
############################################################################
